M03
20
15
3
32
32
B
G1 G1 G1 G1 G1 G1 G1 G1 G1 G1 G1 G1 G1 G1 G1 G1 G1 G1 G1 G1 
G1 G1 G1 G1 G1 G1 G1 G1 G1 G1 G1 G1 G1 G1 G1 G1 G1 G1 G1 G1 
G1 G1 G0 G0 G0 G0 G0 G0 G0 G0 G0 G0 G0 G0 G0 G0 G0 G0 G1 G1 
G1 G1 G0 G0 G0 G0 G0 G0 G0 G0 G0 G0 G0 G0 G0 G0 G0 G0 G1 G1 
G1 G1 G0 G0 G0 G0 G0 G0 G0 G0 G0 G0 G0 G0 G0 G0 G0 G0 G1 G1 
G1 G1 G0 G0 G0 G0 G0 G0 G0 G0 G0 G0 G0 G0 G0 G0 G0 G0 G1 G1 
G1 G1 G0 G0 G0 G0 G0 G0 G0 G0 G0 G0 G0 G0 G0 G0 G0 G0 G1 G1 
G1 G1 G0 G0 G0 G0 G0 G0 G0 G0 G0 G0 G0 G0 G0 G0 G0 G0 G1 G1 
G1 G1 G0 G0 G0 G0 G0 G0 G0 G0 G0 G0 G0 G0 G0 G0 G0 G0 G1 G1 
G1 G1 G0 G0 G0 G0 G0 G0 G0 G0 G0 G0 G0 G0 G0 G0 G0 G0 G1 G1 
G1 G1 G0 G0 G0 G0 G0 G0 G0 G0 G0 G0 G0 G0 G0 G0 G0 G0 G1 G1 
G1 G1 G0 G0 G0 G0 G0 G0 G0 G0 G0 G0 G0 G0 G0 G0 G0 G0 G1 G1 
G1 G1 G0 G0 G0 G0 G0 G0 G0 G0 G0 G0 G0 G0 G0 G0 G0 G0 G1 G1 
G1 G1 G1 G1 G1 G1 G1 G1 G1 G1 G1 G1 G1 G1 G1 G1 G1 G1 G1 G1 
G1 G1 G1 G1 G1 G1 G1 G1 G1 G1 G1 G1 G1 G1 G1 G1 G1 G1 G1 G1 
O
W2 W0 W0 W0 W0 W0 W0 W0 W0 W0 W0 W0 W0 W0 W0 W0 W0 W0 W0 W3 
W1 VE VE VE VE VE XX XX XX XX XX XX XX XX VE VE VE VE VE W1 
W1 XX VE VE VE XX XX XX XX XX XX XX XX XX XX VE VE VE XX W1 
W1 XX XX XX XX XX XX XX XX XX XX XX XX XX XX XX XX XX XX W1 
W1 XX XX XX VE XX XX XX XX XX XX XX XX XX VE XX XX XX XX W1 
W1 XX XX XX XX XX XX XX XX XX XX XX XX XX XX XX XX XX XX W1 
W1 XX XX XX VE XX XX VE XX XX XX VE XX XX VE XX XX XX XX W1 
W1 XX XX XX XX XX XX XX XX XX XX XX XX XX XX XX XX XX XX W1 
W1 XX XX XX VE XX XX XX XX XX XX XX XX XX VE XX XX XX XX W1 
W1 XX XX XX XX XX XX VE XX XX XX VE XX XX XX XX XX XX XX W1 
W1 XX XX XX VE XX XX XX XX XX XX XX XX XX VE XX XX XX XX W1 
W1 XX XX XX XX XX XX XX XX XX XX XX XX XX XX XX XX XX XX W1 
W1 XX XX XX XX XX XX XX XX XX XX XX XX XX XX XX XX XX XX W1 
W1 XX XX XX XX XX XX XX XX XX XX XX XX XX XX XX XX XX XX W1 
W4 W0 W0 W0 W0 W0 W0 W0 W0 W0 W0 W0 W0 W0 W0 W0 W0 W0 W0 W5 
C
XX XX XX XX XX XX XX XX XX XX XX XX XX XX XX XX XX XX XX XX 
XX XX XX XX XX XX XX XX XX XX XX XX XX XX XX XX XX XX XX XX 
XX XX XX XX XX XX XX XX XX XX XX XX XX XX XX XX XX XX XX XX 
XX XX XX XX XX XX XX XX XX XX XX XX XX XX XX XX XX XX XX XX 
XX XX XX XX XX A0 XX XX XX XX XX XX XX XX XX XX XX XX XX XX 
XX XX XX XX XX XX XX XX XX XX XX XX XX XX XX XX XX XX XX XX 
XX XX XX XX XX XX XX XX XX XX XX XX XX XX XX XX XX XX XX XX 
XX XX XX XX XX XX XX XX XX XX XX XX XX XX XX XX XX XX XX XX 
XX XX XX XX XX XX XX XX XX XX XX XX XX XX XX XX XX XX XX XX 
XX XX XX XX XX XX XX XX XX XX XX XX XX XX XX XX XX XX XX XX 
XX XX XX XX XX XX XX XX XX XX XX XX XX XX XX XX XX XX XX XX 
XX XX XX XX XX XX XX XX XX XX XX XX XX XX XX XX XX XX XX XX 
XX XX XX XX XX XX XX XX XX XX A0 XX XX XX XX XX XX XX XX XX 
XX XX XX XX XX XX XX XX XX XX XX XX XX XX XX XX XX XX XX XX 
XX XX XX XX XX XX XX XX XX XX XX XX XX XX XX XX XX XX XX XX 
