M01
20
15
3
32
32
B
R0 R0 R0 R0 R0 R0 R0 R0 R0 R0 R0 R0 R0 R0 R0 R0 R0 R0 R0 R0
R0 R0 R0 R0 R0 R0 R0 R0 R0 R0 R0 R0 R0 R0 R0 R0 R0 R0 R0 R0
R0 R0 G0 G0 G0 G0 R0 G0 G0 G0 G0 G0 G0 G0 G0 G0 G0 G0 R0 R0
R0 R0 G0 G0 G0 G0 R0 G0 G0 G0 G0 G0 G0 G0 G0 G0 G0 G0 R0 R0
R0 R0 G0 G0 G0 G0 R0 G0 G0 G0 G0 G0 G0 G0 G0 G0 G0 G0 R0 R0
R0 R0 G0 G0 G0 G0 R0 G0 G0 G0 G0 G0 G0 G0 G0 G0 G0 G0 R0 R0
R0 R0 G0 G0 G0 G0 R0 G0 G0 G0 G0 G0 G0 G0 G0 G0 G0 G0 R0 R0
R0 R0 G0 G0 G0 G0 R0 G0 G0 G0 G0 G0 G0 G0 G0 G0 G0 G0 R0 R0
R0 R0 G0 G0 G0 G0 R0 G0 G0 G0 G0 G0 G0 G0 G0 G0 G0 G0 R0 R0
R0 R0 G0 G0 G0 G0 R0 G0 G0 G0 G0 G0 G0 G0 G0 G0 G0 G0 G0 R0
R0 R0 G0 G0 G0 G0 R0 G0 G0 G0 G0 G0 G0 R0 G0 G0 G0 G0 R0 R0
R0 R0 G0 G0 G0 G0 R0 G0 G0 G0 G0 G0 G0 G0 G0 G0 G0 G0 R0 R0
R0 R0 G0 G0 G0 G0 R0 G0 G0 G0 G0 G0 G0 G0 G0 G0 G0 G0 R0 R0
R0 R0 R0 R0 R0 R0 G0 R0 R0 R0 R0 R0 R0 R0 R0 R0 R0 R0 R0 R0
R0 R0 R0 R0 R0 R0 R0 R0 R0 R0 R0 R0 R0 R0 R0 R0 R0 R0 R0 R0
O
W2 W6 D0 W7 W0 W0 W0 W0 W6 D1 D2 W7 W0 W0 W0 W0 W0 W0 W0 W3
W1 XX XX XX XX XX XX XX XX XX XX XX XX XX XX XX XX XX XX W7
W1 XX XX XX XX XX XX XX XX XX XX XX XX XX XX XX XX XX XX D3
W1 XX XX XX XX XX XX XX XX XX XX XX XX XX XX XX XX XX XX W8
W1 XX XX XX XX XX XX XX XX XX XX XX XX XX XX XX XX XX XX W1
W6 XX XX XX XX XX XX XX XX XX XX XX XX XX XX XX XX XX XX W1
DA XX XX XX XX XX XX XX XX XX XX XX XX XX XX XX XX XX XX W7
DB XX XX XX XX XX XX XX XX XX XX XX XX XX XX XX XX XX XX D4
W9 XX XX XX XX XX XX XX XX XX XX XX XX XX XX XX XX XX XX D5
W1 XX XX XX XX XX XX XX XX XX XX XX XX XX XX XX XX XX XX W8
W1 XX XX XX XX XX XX XX XX XX XX XX XX XX XX XX XX XX XX W1
W6 XX XX XX XX XX XX XX XX XX XX XX XX XX XX XX XX XX XX W1
D9 XX XX XX XX XX XX XX XX XX XX XX XX XX XX XX XX XX XX W1
W9 XX XX XX XX XX XX XX XX XX XX XX XX XX XX XX XX XX XX W1
W4 W9 D6 W8 W0 W0 W0 W0 W9 D7 D8 W8 W0 W0 W0 W0 W0 W0 W0 W5
C
XX XX XX XX XX XX XX XX XX XX XX XX XX XX XX XX XX XX XX XX
XX XX XX XX XX XX XX XX XX XX XX XX XX XX XX XX XX XX XX XX
XX XX A0 XX XX XX XX XX XX XX XX XX XX XX XX XX XX XX XX XX
XX XX XX XX XX XX XX XX XX XX XX XX XX XX XX XX XX XX XX XX
XX XX XX XX XX XX XX XX XX XX XX XX XX XX XX XX XX XX XX XX
XX XX A0 XX XX XX XX XX XX XX XX XX XX XX XX XX XX XX XX XX
XX XX XX XX XX XX XX XX XX XX XX XX XX XX XX XX XX XX XX XX
XX XX XX XX XX XX XX XX XX XX XX XX XX XX XX XX XX XX XX XX
XX XX XX XX XX A0 XX XX XX XX XX XX XX XX XX XX XX XX XX XX
XX XX XX XX XX XX XX XX XX XX XX XX XX XX XX XX XX XX XX XX
XX XX XX XX XX XX XX XX XX XX XX XX XX XX XX XX XX XX XX XX
XX XX XX XX XX XX XX XX XX XX XX XX XX XX XX XX XX XX XX XX
XX XX XX XX XX XX XX XX XX XX XX XX XX XX XX XX XX A0 XX XX
XX XX XX XX XX XX XX XX XX XX XX XX XX XX XX XX XX XX XX XX
XX XX XX XX XX XX XX XX XX XX XX XX XX XX XX XX XX XX XX XX
P
225
225

//Comments:
//Map ID
//Number of Columns
//Number of Rows
//Number of Layers
//Tiles width
//Tiles height
//Layer ID
//XX = Blank Tile
//Should probably have an initial spawn point somewhere
//Creatures/other entities should not be assigned to a grid - just give world coordinates (maybe even a node if we have them)