M01
20
15
3
32
32
B
R0 R0 R0 R0 R0 R0 R0 R0 R0 R0 R0 R0 R0 R0 R0 R0 R0 R0 R0 R0
R0 R0 R0 R0 R0 R0 R0 R0 R0 R0 R0 R0 R0 R0 R0 R0 R0 R0 R0 R0
R0 R0 G0 G0 G0 G0 G0 G0 R0 R0 R0 G0 G0 G0 G0 G0 G0 G0 R0 R0
R0 R0 G0 G0 G0 G0 G0 G0 R0 R0 R0 G0 G0 G0 G0 G0 G0 G0 R0 R0
R0 R0 G0 G0 G0 G0 G0 G0 R0 R0 R0 G0 G0 G0 G0 G0 G0 G0 R0 R0
R0 R0 G0 G0 G0 G0 G0 G0 R0 R0 R0 G0 G0 G0 G0 G0 G0 G0 R0 R0
R0 R0 G0 G0 G0 G0 G0 G0 R0 R0 R0 G0 G0 G0 G0 G0 G0 G0 R0 R0
R0 R0 G0 G0 G0 G0 G0 G0 R0 R0 R0 G0 G0 G0 G0 G0 G0 G0 R0 R0
R0 R0 G0 G0 G0 G0 G0 G0 R0 R0 R0 G0 G0 G0 G0 G0 G0 G0 R0 R0
R0 R0 G0 G0 G0 G0 G0 G0 R0 R0 R0 G0 G0 G0 G0 G0 G0 G0 R0 R0
R0 R0 G0 G0 G0 G0 G0 G0 R0 R0 R0 G0 G0 G0 G0 G0 G0 G0 R0 R0
R0 R0 G0 G0 G0 G0 G0 G0 R0 R0 R0 G0 G0 G0 G0 G0 G0 G0 R0 R0
R0 R0 G0 G0 G0 G0 G0 G0 R0 R0 R0 G0 G0 G0 G0 G0 G0 G0 R0 R0
R0 R0 R0 R0 R0 R0 R0 R0 R0 R0 R0 R0 R0 R0 R0 R0 R0 R0 R0 R0
R0 R0 R0 R0 R0 R0 R0 R0 R0 R0 R0 R0 R0 R0 R0 R0 R0 R0 R0 R0
O
W2 W0 W0 W0 W0 W0 W0 W0 W0 W0 W0 W0 W0 W0 W0 W0 W0 W0 W0 W3
W1 XX XX XX XX XX XX XX XX XX XX XX XX XX XX XX XX XX XX W1
W1 XX XX XX XX XX XX XX XX XX XX XX XX XX XX XX XX XX XX W1
W1 XX XX XX XX XX XX XX XX XX XX XX XX XX XX XX XX XX XX W1
W1 XX XX XX XX XX XX XX XX XX XX XX XX XX XX XX XX XX XX W1
W1 XX XX XX XX XX XX XX XX XX XX XX XX XX XX XX XX XX XX W1
W1 XX XX XX XX XX XX XX XX XX XX XX XX XX XX XX XX XX XX W1
W1 XX XX XX XX XX XX XX XX XX XX XX XX XX XX XX XX XX XX W1
W1 XX XX XX XX XX XX XX XX XX XX XX XX XX XX XX XX XX XX W1
W1 XX XX XX XX XX XX XX XX XX XX XX XX XX XX XX XX XX XX W1
W1 XX XX XX XX XX XX XX XX XX XX XX XX XX XX XX XX XX XX W1
W1 XX XX XX XX XX XX XX XX XX XX XX XX XX XX XX XX XX XX W1
W1 XX XX XX XX XX XX XX XX XX XX XX XX XX XX XX XX XX XX W1
W1 XX XX XX XX XX XX XX XX XX XX XX XX XX XX XX XX XX XX W1
W4 W0 W0 W0 W0 W0 W0 W0 W0 W0 W0 W0 W0 W0 W0 W0 W0 W0 W0 W5
C
XX XX XX XX XX XX XX XX XX XX XX XX XX XX XX XX XX XX XX XX
XX XX XX XX XX XX XX XX XX XX XX XX XX XX XX XX XX XX XX XX
XX XX A0 XX XX XX XX XX XX XX XX XX XX XX XX XX XX XX XX XX
XX XX XX XX XX XX XX XX XX XX XX XX XX XX XX XX XX XX XX XX
XX XX XX XX XX XX XX XX XX XX XX XX XX XX XX XX XX XX XX XX
XX XX A0 XX XX XX XX XX XX XX XX XX XX XX XX XX XX XX XX XX
XX XX XX XX XX XX XX XX XX XX XX XX XX XX XX XX XX XX XX XX
XX XX XX XX XX XX XX XX XX XX XX XX XX XX XX XX XX XX XX XX
XX XX XX XX XX A0 XX XX XX XX XX XX XX XX XX XX XX XX XX XX
XX XX XX XX XX XX XX XX XX XX XX XX XX XX XX XX XX XX XX XX
XX XX XX XX XX XX XX XX XX XX XX XX XX XX XX XX XX XX XX XX
XX XX XX XX XX XX XX XX XX XX XX XX XX XX XX XX XX XX XX XX
XX XX XX XX XX XX XX XX XX XX XX XX XX XX XX XX XX A0 XX XX
XX XX XX XX XX XX XX XX XX XX XX XX XX XX XX XX XX XX XX XX
XX XX XX XX XX XX XX XX XX XX XX XX XX XX XX XX XX XX XX XX
P
225
225

//Comments:
//Map ID
//Number of Columns
//Number of Rows
//Number of Layers
//Tiles width
//Tiles height
//Layer ID
//XX = Blank Tile
//Should probably have an initial spawn point somewhere
//Creatures/other entities should not be assigned to a grid - just give world coordinates (maybe even a node if we have them)